# # # # # # # # # # # # # # # # #
# . . . . . . . # . . . . . . . #
# . . . . . . . # . . . . . . . #
# . . . . . . . . . . . . . . . #
# . . . . . . . # . . . . . . . #
# . . . . . . . # . . . . . . . #
# . . . . . . . # . . . . . . . #
# . . . . . . . # . . . . . . . #
# # . # # # # # # . . . . . . . #
# . . . . . . . # . . . . . . . #
# . . . . . . . # # # # . # # # #
# . . . . . . . # . . . . . . . #
# . . . . . . . . . . . . . . . #
# . . . . . . . # . . . . . . . #
# . . . . . . . # . . . . . . . #
# . . . . . . . # . . . . . . . #
# # # # # # # # # # # # # # # # #