# # # # # # # # #
# . . . # . . . #
# . . . # . . . #
# . . . . . . . #
# . . . # # . # #
# . # # # . . . #
# . . . # . . . #
# . . . . . . . #
# # # # # # # # #