# # # # # # # # # # # # #
# . . . . . # . . . . . #
# . . . . . # . . . . . #
# . . . . . . . . . . . #
# . . . . . # . . . . . #
# . . . . . # . . . . . #
# # . # # # # . . . . . #
# . . . . . # # # . # # #
# . . . . . # . . . . . #
# . . . . . # . . . . . #
# . . . . . . . . . . . #
# . . . . . # . . . . . #
# # # # # # # # # # # # #