# # # # # # # # # # #
# . . . . # . . . . #
# . . . . # . . . . #
# . . . . . . . . . #
# . . . . # . . . . #
# # . # # # . . . . #
# . . . . # # # # . #
# . . . . # . . . . #
# . . . . # . . . . #
# . . . . # . . . . #
# # # # # # # # # # #