# # # # # # # # # # # # # # # # # # # # # # # # #
# . . . . . # . . . . . . . . . . . # . . . . . #
# . . . . . # . . . . . # . . . . . # . . . . . #
# . . . . . # . . . . . # . . . . . # . . . . . #
# . . . . . . . . . . . # . . . . . # . . . . . #
# . . . . . # . . . . . # . . . . . . . . . . . #
# . # # # # # . . . . . # # # # # . # . . . . . #
# . . . . . # # # # . # # . . . . . # # . # # # #
# . . . . . # . . . . . . . . . . . # . . . . . #
# . . . . . # . . . . . # . . . . . # . . . . . #
# . . . . . # . . . . . # . . . . . # . . . . . #
# . . . . . . . . . . . # . . . . . . . . . . . #
# # # # # # # # # # # # # # # # # # # # # # # # #